1111111111111111111111111111
1000000000000110000000000001
1000000C000X00P0000000000E01
1111111111111111111111111111